########
#PWTBWD#
#C-Vc--#
#h-G---#
#n-----#
#U-----#
########