##########################
#WWWWWW1WWWWWWWffW1WWWWWW#
#------2-SSOOO-FF-2------#
#-n56n-2----------2-n56n-#
#-n78n-3-!444444443-n78n-#
#-n78n--------------n78n-#
#-n90n--n56n--n56n--n90n-#
#-------n78n--n78n-------#
#-------n78n--n78n-------#
#--LR---n90n--n90n---LR--#
###  ################  ###
##########################