##################
#hhWW[=]WW#WWWffW#
#HH-------#---FF-#
#---------#------#
#---D-D-D-#-SOOS-#
#---n-n-n-#------#
#---D-D-D-#-SOOS-#
#---n-n-n-W------#
#-----------SOOS-#
#----LR----------#
#####  ###########
