######################
#hhWWW[=]W##W[=]WWWhh#
#HH-------##-------HH#
#---------##---------#
#----SDDD-##pcpcpc---#
#-----nnn-##PCPCPC---#
#----SDDD-##pcpcpc---#
#-----nnn-##PCPCPC---#
#-LR------##------LR-#
##  ##############  ##
