##################
#W12WWW#WW[=]WWhh#
#-34---#-------HH#
#------#---------#
#-56---#-D-D-D---#
#-78---#-n-n-n---#
#------#-D-D-D---#
#---56-W-n-n-n---#
#---78-----------#
#-----------LR---#
############  ####