####################
#WwwwwWWW$$?WWwwwwW#
#------------------#
#------------------#
#--##############--#
#--##############--#
#--##############--#
#--##############--#
#--##############--#
#--##############--#
#--WD?WWWWWWWWWD?--#
#------------------#
#--------LR--------#
#########vv#########
####################