#################
#hhwwwP##########
#HH()-C##########
#------##########
#--<>-^##########
#--\/-X##########
#------##########
#-?WWW7WWWWWWTWW#
#-----8------VB-#
#-----W---------#
#W-----------oo-#
#---------------#
#-WWWWWf7--n12n-#
#----SOF8--n34n-#
#-------W--n56n-#
#---------------#
##############LR#
##############  #
#################